_E_T__T___
__TT__TTTT
_E_______T
TTTT__T__T
_____X____
_E________